"filename", "language", "CSS", "Vue.js", "TypeScript", "comment", "blank", "total"
"c:\Users\15701\Desktop\ceshits\src\App.vue", "Vue.js", 0, 84, 0, 0, 13, 97
"c:\Users\15701\Desktop\ceshits\src\api\index.ts", "TypeScript", 0, 0, 50, 9, 4, 63
"c:\Users\15701\Desktop\ceshits\src\api\photoService.ts", "TypeScript", 0, 0, 151, 23, 24, 198
"c:\Users\15701\Desktop\ceshits\src\assets\FilterPantel.css", "CSS", 370, 0, 0, 10, 64, 444
"c:\Users\15701\Desktop\ceshits\src\assets\HomeView.css", "CSS", 293, 0, 0, 15, 49, 357
"c:\Users\15701\Desktop\ceshits\src\assets\base.css", "CSS", 71, 0, 0, 2, 14, 87
"c:\Users\15701\Desktop\ceshits\src\assets\main.css", "CSS", 30, 0, 0, 1, 5, 36
"c:\Users\15701\Desktop\ceshits\src\assets\styles\PreviewView.css", "CSS", 627, 0, 0, 12, 97, 736
"c:\Users\15701\Desktop\ceshits\src\assets\styles\chat.css", "CSS", 197, 0, 0, 4, 34, 235
"c:\Users\15701\Desktop\ceshits\src\assets\styles\imageGroupDetail.css", "CSS", 460, 0, 0, 12, 75, 547
"c:\Users\15701\Desktop\ceshits\src\assets\styles\notification-indicator.css", "CSS", 37, 0, 0, 6, 5, 48
"c:\Users\15701\Desktop\ceshits\src\assets\styles\notifications.css", "CSS", 348, 0, 0, 11, 57, 416
"c:\Users\15701\Desktop\ceshits\src\assets\styles\profileView.css", "CSS", 478, 0, 0, 4, 76, 558
"c:\Users\15701\Desktop\ceshits\src\components\FilterPanel.vue", "Vue.js", 0, 695, 0, 102, 94, 891
"c:\Users\15701\Desktop\ceshits\src\components\FullScreenViewer.vue", "Vue.js", 0, 466, 0, 68, 91, 625
"c:\Users\15701\Desktop\ceshits\src\components\ImageViewer.vue", "Vue.js", 0, 255, 0, 25, 46, 326
"c:\Users\15701\Desktop\ceshits\src\components\LoginModal.vue", "Vue.js", 0, 177, 0, 4, 24, 205
"c:\Users\15701\Desktop\ceshits\src\components\TabBar.vue", "Vue.js", 0, 108, 0, 5, 13, 126
"c:\Users\15701\Desktop\ceshits\src\components\Toast.vue", "Vue.js", 0, 87, 0, 11, 17, 115
"c:\Users\15701\Desktop\ceshits\src\components\TopBar.vue", "Vue.js", 0, 104, 0, 5, 18, 127
"c:\Users\15701\Desktop\ceshits\src\composables\useAuth.ts", "TypeScript", 0, 0, 109, 27, 23, 159
"c:\Users\15701\Desktop\ceshits\src\composables\useImageDetail.ts", "TypeScript", 0, 0, 265, 15, 23, 303
"c:\Users\15701\Desktop\ceshits\src\composables\useNotifications.ts", "TypeScript", 0, 0, 154, 16, 17, 187
"c:\Users\15701\Desktop\ceshits\src\composables\useToast.ts", "TypeScript", 0, 0, 66, 18, 17, 101
"c:\Users\15701\Desktop\ceshits\src\main.ts", "TypeScript", 0, 0, 17, 5, 5, 27
"c:\Users\15701\Desktop\ceshits\src\router\index.ts", "TypeScript", 0, 0, 68, 2, 6, 76
"c:\Users\15701\Desktop\ceshits\src\shims-vue.d.ts", "TypeScript", 0, 0, 5, 1, 1, 7
"c:\Users\15701\Desktop\ceshits\src\stores\counter.ts", "TypeScript", 0, 0, 10, 0, 3, 13
"c:\Users\15701\Desktop\ceshits\src\stores\imageStore.ts", "TypeScript", 0, 0, 27, 3, 6, 36
"c:\Users\15701\Desktop\ceshits\src\stores\searchStore.ts", "TypeScript", 0, 0, 244, 39, 39, 322
"c:\Users\15701\Desktop\ceshits\src\stores\user.ts", "TypeScript", 0, 0, 53, 4, 9, 66
"c:\Users\15701\Desktop\ceshits\src\views\ChatView.vue", "Vue.js", 0, 310, 0, 15, 52, 377
"c:\Users\15701\Desktop\ceshits\src\views\ExploreView.vue", "Vue.js", 0, 247, 0, 12, 46, 305
"c:\Users\15701\Desktop\ceshits\src\views\HomeView.vue", "Vue.js", 0, 146, 0, 13, 15, 174
"c:\Users\15701\Desktop\ceshits\src\views\ImageGroupDetailView.vue", "Vue.js", 0, 177, 0, 8, 13, 198
"c:\Users\15701\Desktop\ceshits\src\views\NotificationsView.vue", "Vue.js", 0, 389, 0, 23, 31, 443
"c:\Users\15701\Desktop\ceshits\src\views\PreviewView.vue", "Vue.js", 0, 434, 0, 48, 65, 547
"c:\Users\15701\Desktop\ceshits\src\views\ProfileView.vue", "Vue.js", 0, 196, 0, 23, 23, 242
"c:\Users\15701\Desktop\ceshits\src\views\SearchView.vue", "Vue.js", 0, 431, 0, 60, 73, 564
"Total", "-", 2911, 4306, 1219, 661, 1287, 10384