"filename", "language", "Vue.js", "TypeScript", "CSS", "comment", "blank", "total"
"c:\Users\15701\Desktop\ceshits\src\App.vue", "Vue.js", 83, 0, 0, 1, 13, 97
"c:\Users\15701\Desktop\ceshits\src\api\index.ts", "TypeScript", 0, 50, 0, 9, 4, 63
"c:\Users\15701\Desktop\ceshits\src\api\photoService.ts", "TypeScript", 0, 151, 0, 23, 24, 198
"c:\Users\15701\Desktop\ceshits\src\assets\FilterPantel.css", "CSS", 0, 0, 370, 10, 64, 444
"c:\Users\15701\Desktop\ceshits\src\assets\HomeView.css", "CSS", 0, 0, 293, 15, 49, 357
"c:\Users\15701\Desktop\ceshits\src\assets\base.css", "CSS", 0, 0, 71, 2, 14, 87
"c:\Users\15701\Desktop\ceshits\src\assets\main.css", "CSS", 0, 0, 30, 1, 5, 36
"c:\Users\15701\Desktop\ceshits\src\assets\styles\PreviewView.css", "CSS", 0, 0, 627, 12, 97, 736
"c:\Users\15701\Desktop\ceshits\src\assets\styles\aboutView.css", "CSS", 0, 0, 563, 15, 93, 671
"c:\Users\15701\Desktop\ceshits\src\assets\styles\chat.css", "CSS", 0, 0, 197, 4, 34, 235
"c:\Users\15701\Desktop\ceshits\src\assets\styles\imageGroupDetail.css", "CSS", 0, 0, 460, 12, 75, 547
"c:\Users\15701\Desktop\ceshits\src\assets\styles\messages.css", "CSS", 0, 0, 213, 7, 34, 254
"c:\Users\15701\Desktop\ceshits\src\assets\styles\notification-indicator.css", "CSS", 0, 0, 34, 6, 5, 45
"c:\Users\15701\Desktop\ceshits\src\assets\styles\notifications.css", "CSS", 0, 0, 348, 11, 57, 416
"c:\Users\15701\Desktop\ceshits\src\assets\styles\previewother.css", "CSS", 0, 0, 854, 19, 148, 1021
"c:\Users\15701\Desktop\ceshits\src\assets\styles\profileView.css", "CSS", 0, 0, 467, 16, 76, 559
"c:\Users\15701\Desktop\ceshits\src\components\FilterPanel.vue", "Vue.js", 695, 0, 0, 102, 94, 891
"c:\Users\15701\Desktop\ceshits\src\components\FullScreenViewer.vue", "Vue.js", 466, 0, 0, 68, 91, 625
"c:\Users\15701\Desktop\ceshits\src\components\ImageViewer.vue", "Vue.js", 255, 0, 0, 25, 46, 326
"c:\Users\15701\Desktop\ceshits\src\components\LoginModal.vue", "Vue.js", 177, 0, 0, 4, 24, 205
"c:\Users\15701\Desktop\ceshits\src\components\TabBar.vue", "Vue.js", 108, 0, 0, 5, 13, 126
"c:\Users\15701\Desktop\ceshits\src\components\Toast.vue", "Vue.js", 87, 0, 0, 11, 17, 115
"c:\Users\15701\Desktop\ceshits\src\components\TopBar.vue", "Vue.js", 106, 0, 0, 5, 18, 129
"c:\Users\15701\Desktop\ceshits\src\components\preview\PreviewDayCard.vue", "Vue.js", 235, 0, 0, 20, 35, 290
"c:\Users\15701\Desktop\ceshits\src\components\preview\PreviewDetailModal.vue", "Vue.js", 233, 0, 0, 15, 24, 272
"c:\Users\15701\Desktop\ceshits\src\composables\useAuth.ts", "TypeScript", 0, 109, 0, 50, 23, 182
"c:\Users\15701\Desktop\ceshits\src\composables\useImageDetail.ts", "TypeScript", 0, 265, 0, 15, 23, 303
"c:\Users\15701\Desktop\ceshits\src\composables\useMessages.ts", "TypeScript", 0, 118, 0, 26, 25, 169
"c:\Users\15701\Desktop\ceshits\src\composables\useNotifications.ts", "TypeScript", 0, 200, 0, 28, 28, 256
"c:\Users\15701\Desktop\ceshits\src\composables\useToast.ts", "TypeScript", 0, 66, 0, 18, 17, 101
"c:\Users\15701\Desktop\ceshits\src\main.ts", "TypeScript", 0, 17, 0, 5, 5, 27
"c:\Users\15701\Desktop\ceshits\src\router\index.ts", "TypeScript", 0, 80, 0, 2, 6, 88
"c:\Users\15701\Desktop\ceshits\src\shims-vue.d.ts", "TypeScript", 0, 5, 0, 1, 1, 7
"c:\Users\15701\Desktop\ceshits\src\stores\counter.ts", "TypeScript", 0, 10, 0, 0, 3, 13
"c:\Users\15701\Desktop\ceshits\src\stores\imageStore.ts", "TypeScript", 0, 27, 0, 3, 6, 36
"c:\Users\15701\Desktop\ceshits\src\stores\searchStore.ts", "TypeScript", 0, 244, 0, 39, 39, 322
"c:\Users\15701\Desktop\ceshits\src\stores\user.ts", "TypeScript", 0, 4, 0, 72, 3, 79
"c:\Users\15701\Desktop\ceshits\src\views\AboutView.vue", "Vue.js", 664, 0, 0, 26, 62, 752
"c:\Users\15701\Desktop\ceshits\src\views\ChatView.vue", "Vue.js", 322, 0, 0, 17, 56, 395
"c:\Users\15701\Desktop\ceshits\src\views\ExploreView.vue", "Vue.js", 247, 0, 0, 12, 46, 305
"c:\Users\15701\Desktop\ceshits\src\views\FeedbackView.vue", "Vue.js", 562, 0, 0, 34, 85, 681
"c:\Users\15701\Desktop\ceshits\src\views\HomeView.vue", "Vue.js", 146, 0, 0, 13, 15, 174
"c:\Users\15701\Desktop\ceshits\src\views\ImageGroupDetailView.vue", "Vue.js", 177, 0, 0, 8, 13, 198
"c:\Users\15701\Desktop\ceshits\src\views\NotificationsView.vue", "Vue.js", 363, 0, 0, 25, 30, 418
"c:\Users\15701\Desktop\ceshits\src\views\PreviewView.vue", "Vue.js", 366, 0, 0, 40, 51, 457
"c:\Users\15701\Desktop\ceshits\src\views\ProfileView.vue", "Vue.js", 198, 0, 0, 23, 23, 244
"c:\Users\15701\Desktop\ceshits\src\views\SearchView.vue", "Vue.js", 431, 0, 0, 60, 73, 564
"Total", "-", 5921, 1346, 4527, 935, 1787, 14516